XXXXXXXXXX
XEX X     
X X X XXX 
X X X XXX 
X X X XXX 
X X X  X  
X X X  X X
X X    X  
X   XX XX 
XXXXXXSXX 
